25
16
1111111111111111111111111
1222222222221333333333331
1222222222221333333333331
1222222222221333333333331
1222222222221333333333331
1222222222221111144111111
1222222222222222222222221
1222222222222222222222221
1222222222222222222222221
1222222222222222222222221
1222222222222222222222221
1222222222222222222222221
1222222222222222222222221
1222222222222222222222221
1222222222222222222222221
1111111111111111111111111
