31
19
1111111111111111111111111111111
1222222222222222222222222333331
1222222222222222222222222333331
1222222222222222222222222333331
1222222222222222222222222333331
1222222222222222222222222333331
1222222222222222222222222222221
1222222222222222222222222222221
1222222222222222222222222222221
1222222222222222222222222222221
1222222222222222222222222222221
1222222222222222222222222222221
1222222222222222222222222222221
1222222222222222222222222222221
1222222222222222222222222222221
1222222222222222222222222222221
1222222222222222222222222222221
1222222222222222222222222222221
1111111111111111111111111111111
